####################################################
#                                                  #
#                                                  #
#               PPP                                #
#                                                  #
#                                                  #
#                                                  #
#                                                  #
#                                                  #
#                                                  #
#                                                  #
#                                                  #
#                                                  #
#                                                  #
####################################################